
Baab
باب فَعَلَ يَفْعُلُ

نصر - to help
خرج - to leave
دخل - to enter
قعد - to sit up
طلب - to seek
هرب - to flee
حرث - to plow
ستر - to cover
مطر - to rain
سكت - to stay silent
خلد - to be immortal; to remain forever
لمس - to touch;feel w/hand
سقط - to fall
بلغ - to reach
خلط - to mix
نسج - to weave
رقد - to sleep
فتل - to twist together
نفخ - to blow
ترك - to leave/abandon 
غرز - to prick
نقض - to destroy
مكث - to remain
نشر - to spread
قنت - to obey
ركض - to strike
نقص - to decrease
------------------

Baab
باب فَعَلَ يَفْعِلُ

ضرب - to hit
غلب - to overcome
كذب - to lie
كسب - to earn
قصد - to make an intention
غفر - to forgive
كسر - to break
جلس - to sit down
صبر - to wait; to be patient
حبس - to withhold; to confine
رجع - to return
صرف - to turn away
عرف - to know and recognize
كشف - to uncover
عصر- to squeeze
غزل- to spin
حلق - to shave
خرق - to rip
سرق - to steal
هلك - to die
حمل - to pick up/carry
عدل - to be just
نزل - to descend
غسل - to shower
-----------------

Baab
باب فَعَلَ يَفْعَلُ

فتح  - to open
ذهب - to go
جرح - to wound
مدح - to praise (usually used for humans/things)
جحد - to negate; to refuse
نهض - to rise
رفع - to raise
قطع - to cut
منع - to stop; to prevent
جعل - to make
طبخ - to cook
مضع - to chew
طحن - to grind
سحق - to crush
صرخ - to cry; to yell
سبح - to swim
خلع - to remove
قلع - to pluck out
----------------

Baab
باب فَعِلَ يَفْعَلُ

سمع - to listen
شرب - to drink
لبث - to delay
حمد - to praise (used for Allaah)
سعد - to be fortunate
لعق - to lick
شهد - to witness
لبس - to put on, wear
عطش - to be thirsty
حفظ - to preserve
ضحك - to laugh
جهل - to be ignorant
علم - to know
فهم - to understand
قدم - to arrive
لحق - to catch up
ركب - to ride
----------

Baab
باب فَعُلَ يَفْعُلُ

كرم - to be noble, honorable
قرب - to be near
بعد - to be far
بصر - to look
كثر - to be much
صعب - to be difficult
شرف - to be noble, eminent, distinguished
عظم - to be(come) great
--------------

Baab
باب فَعِلَ يَفْعِلُ

حسب - to compute; to think 
نعم - to lead a life of ease
--------------